﻿#date
OpenButton=Ouvrir un fichier de maillage
LaunchButton=Lancer le traitement
AbortButton=Arrêter le traitement de cet îlot
BackButton=Retourner au traitement précédent
ProcessTitle1=Découper en sol et bâtiment
ProcessTitle2=Découper les bâtiments entre eux
ProcessTitle3=Séparer les murs et les toits de chaque bâtiment
ProcessTitle4=Séparer les murs et les toits entre eux pour chaque bâtiment
ProcessTitle5=Déterminer les voisins de chaque mur ou toit
ProcessTitle6=Trier les voisins de chaque mur ou toit
StepTitle1=Etape 1/6 : Début du traitement
StepTitle2=Etape 2/6 : Sols et bâtiments découpés
StepTitle3=Etape 3/6 : Bâtiments découpés entre eux
StepTitle4=Etape 4/6 : Murs et toits découpés
StepTitle5=Etape 5/6 : Murs et toits découpés entre eux
StepTitle6=Etape 6/6 : Surfaces simplifiées
IsletProcess=Ilot : étape 
CType=Type
CDelete=Supprimer
CMerge=Fusionner
CPutInNoise=Mettre dans le bruit
CSortOutNeighbors=Trier les voisins
UseGravityNormal=Utiliser la normale orientée selon la gravité
RotationCenter=Modifier le centre de rotation
DisplayMeshes=Afficher les maillages
DisplayPolygons=Afficher les polygones
LockMesh=Verouiller le maillage
UnlockMesh=Déverouiller le maillage
SelectTriangles=Passer en mode de sélection : triangles
SelectMeshes=Passer en mode de sélection : surfaces
SelectTrianglesLabel=Mode de sélection : triangles
SelectMeshesLabel=Mode de sélection : surfaces
DisplayMeshesLabel=Affichage : Maillages
DisplayPolygonsLabel=Affichage : Polygones
TreeView=Arborescence
Parameters=Paramètres
Title=Nantes 1900
AltitureError=Erreur d'altitude
AngleGroundError=Erreur d'angle au sol
LargeAngleGroundError=Erreur d'angle large au sol
BlockGroundsSizeError=Erreur de taille du sol
BlockBuildingSize=Erreur de taille des bâtiments
NormalToError=Erreur à la normale
LargeAngleError=Erreur d'angle large
MiddleAngleError=Erreur d'angle moyen
PlanesError=Erreur plane
RoofAngleError=Erreur d'angle au toît
RoofSizeError=Erreur de taille du toît
WallAngleError=Erreur d'angle au mur
WallSizeError=Erreur de taille du mur
IsOrientedFactor=Facteur d'orientation
Characteristics=Caractéristiques
ToValid=Valider
HideItem=Cacher l'élément sélectionné
ShowItem=Montrer l'élément sélectionné
FileParamExtension=param
FileParamDescription=Paramètres du programme "Nantes 1900"
SaveResultButton=Sauvegarder les résultats
SaveParametersButton=Sauvegarder les paramètres
LoadParametersButton=Charger les paramètres
ShowParametersButton=Afficher tous les paramètres
SliderDescription=Taille de la sélection
FileSTLDescription=Fichiers STL
